hBBBBBBBBBBjhBBBBBBBBBBjhBBBBBBBBBBjìììììììììììì
b          ìì          ìì         §b           ì
b          ìì          ìì          b           ì
b          ìì          ìì          b           ì
b          ìì          ìì          b           ì
kBBBjììhBBBlkBBBBBBBBBBlkBBBjììhBBBlìììììììììììì
HRRRLììKRRRJHRRRRRRRRRRJaPPPfììdPPPsQYYYYYYYYYYU
r          ìì                      py          y
r          ìì                      ìì          y
r          ìì                      ìì          y
rç         ìì                      py          y
KRRRRRRRRRRLKRRRJììHRRRLdPPPPPPPPPPfEììììììììììT
ì           qWWWtììeWWWuqWWWWWWWWWWuQììììììììììU
ì           w          ìì          wy          y
ì           w          ìì          ìì          y
ì           w          ìì          ìì          y
ì           w          ìì          wy         ùy
ììììììììììììeWWWWWWWWWWteWWWWWWWWWWtEYYYYYYYYYYT
