hBBBBBBBBBBjhBBBBBBBBBBjhBBBBBBBBBBjìììììììììììì
b          ìì         §ìì          b           ì
b          ìì          ìì          b           ì
b          ìì          ìì          b           ì
b          ìì          ìì          b           ì
kBBBjììhBBBlkBBBBBBBBBBlkBBBjììhBBBlìììììììììììì
HRRRLììKRRRJHRRRRRRRRRRJHRRRLììKRRRJQYYYYYYYYYYU
r          ìì                      ry          y
r          ìì                      ìì          y
r          ìì                      ìì          y
rç         ìì                      ry          y
KRRRRRRRRRRLKRRRJììHRRRLKRRRRRRRRRRLEYYYYYYYYYYT
ì           qWWWtììeWWWuqWWWWWWWWWWuQYYYYYYYYYYU
ì           w          ww          wy          y
ì           w          ww          ìì          y
ì           w          ww          ìì          y
ì           w          ww          wy         ùy
ììììììììììììeWWWWWWWWWWteWWWWWWWWWWtEYYYYYYYYYYT
