hBBBBBBBBBBjhBBBBBBBBBBjhBBBBBBBBBBj            
b          ìì         §ìì          b
b          ìì          ìì          b                      
b          ìì          ìì          b                     
b          ìì          ìì          b                     
kBBBjììhBBBlkBBBBBBBBBBlkBBBjììhBBBl            
HRRRLììKRRRJHRRRRRRRRRRJHRRRLììKRRRJQYYYYYYYYYYU
r          ìì                      ry          y
r          ìì                      ìì          y
r          ìì                      ìì          y
rç         ìì                      ry          y
KRRRRRRRRRRLKRRRJììHRRRLKRRRRRRRRRRLEYYYYYYYYYYT
            qWWWtììeWWWuqWWWWWWWWWWuQYYYYYYYYYYU
            w          ww          wy          y
            w          ww          ìì          y
            w          ww          ìì          y
            w          ww          wy         ùy
            eWWWWWWWWWWteWWWWWWWWWWtEYYYYYYYYYYT
