hBBBBBBBBBBjhBBBBBBBBBBjhBBBBBBBBBBjAVVVVVVVVVVS
b          ìì          ìì          bv          v
b          ìì          ìì          ìì          v
b          ìì          ìì          ìì          v
b          ìì          ìì          bv          v
kBBBjììhBBBlkBBBBBBBBBBlkBBBBBBBBBBlDVVVVVVVVVVF
HRRRLììKRRRJHRRRRRRRRRRJQYYYYYYYYYYUQYYYYYYYYYYU
r          ìì          ry          ìì          y
r          ìì          ry          ìì          y
r          ìì          ry          ìì          y
r          ìì          ry          yy          y
KRRRRRRRRRRLKRRRJììHRRRLEììììììììYYTEYYììììììììT
            qWWWtììeWWWuQ        YYUQYY        U
            w          wy          yy          y
            w          ìì          ìì          y
            w          ìì          ìì          y
            w          wy          ìì          y        
            eWWWWWWWWWWtEYYYYYYYYYYTEYYYYYYYYYYT
