hBBBBBBBBBBjhBBBBBBBBBBjhBBBBBBBBBBjAVVVVVVVVVVS
b          ìì          ìì         §bv          v
b          ìì          ìì          ìì          v
b          ìì          ìì          ìì          v
b          ìì          ìì          bv          v
kBBBjììhBBBlkBBBBBBBBBBlkBBBj  hBBBlDVVVS  AVVVF
HRRRLììKRRRJHRRRRRRRRRRJQYYYT  EYYYUQYYYT  EYYYU
r          ìì          ry          ìì          y
r          ìì          ry          ìì          y
r          ìì          ry          ìì          y
rç         ìì          ry          yy          y
KRRRRRRRRRRLKRRRJììHRRRLEììììììììYYTEYYììììììììT
            qWWWtììeWWWuQ        YYUQYY        U
            w          wy          yy          y
            w          ìì          ìì          y
            w          ìì          ìì          y
            w          wy          ìì         ùy
            eWWWWWWWWWWtEYYYYYYYYYYTEYYYYYYYYYYT
