HRRRRRRRRRRJhBBBBBBBBBBjhBBBBBBBBBBjAVVVVVVVVVVS
r          rb          ìì         §bv          v
r          ìì          ìì          ìì          v
r          ìì          ìì          ìì          v
r          rb          ìì          bv          v
KRììììììììRLkBBBjììhBBBlkBBBjììhBBBlDVVVSììAVVVF
HRììììììììRJaPPPfììdPPPsQYYYTììEYYYUQYYYTììEYYYU
r          rp          py          ìì          y
r          rp          py          ìì          y
r          rp          py          ìì          y
rç         rp          py          yy          y
KRRRJììHRRRLdPPPsììaPPPfEììììììììYYTEYYììììììììT
qWWWtììeWWWuqWWWtììeWWWuQììììììììYYUQYYììììììììU
w          ìì          wy          yy          y
w          ìì          ìì          ìì          y
w          ìì          ìì          ìì          y
w          ìì          wy          ìì         ùy
eWWWWWWWWWWteWWWWWWWWWWtEYYYYYYYYYYTEYYYYYYYYYYT
